5,5,5,5,5,5,5,5,5,5,5,5,5,5,5,5,5,5
5,5,5,5,5,5,5,5,5,5,5,5,5,5,5,5,5,5
5,5,5,5,5,5,5,5,5,5,5,5,5,5,5,5,5,5
5,5,5,5,5,5,5,0,2,5,5,5,5,5,5,5,5,5
5,5,5,5,5,5,0,26,24,5,5,5,5,5,5,5,5,5
5,5,5,5,5,5,44,45,46,5,5,5,5,5,5,5,5,5
5,6,7,7,8,5,5,5,5,5,5,5,5,5,5,5,5,5
5,28,29,29,30,5,5,5,5,5,5,5,5,5,5,5,5,5
6,7,7,7,7,8,5,5,5,5,5,5,5,5,5,5,5,5
28,29,29,29,29,30,5,5,5,100,101,101,101,102,5,5,5,5
28,29,29,29,29,30,5,5,5,5,5,5,5,5,5,5,5,5
100,101,101,101,101,101,101,101,101,102,5,5,5,100,102,5,5,5